
  #####
 ##   ##
##     ##
# $#.#$ #
#  .@.  #
# $#.#$ #
##     ##
 ##   ##
  #####